     *****
******._.*
*...**|_.*
*§|||.._.*
**..*.._.*
 *..******
 ****     
