     *****
******._.*
*.§.**|_.*
*.|||.._.*
**..*.._.*
 *..******
 ****     
